1111111111111111111111111111111111111111111111111111111111111
1000000000000000000000000000000000000000000000000000000000001
1000000000000000000000000000000000000000000000000000000000001
1004444444444444444444444444444444444444444444444444444444001
1004444444444444444444444444444444444444444444444444444444001
1004444444444444444444444444444444444444444444444444444444001
1004444444444444444444444444444444444444444444444444444444001
1004444444444444444444444444444444444444444444444444444444001
1004444444444444444444444444444444444444444444444444444444001
1004444444444444444444444444444444444444444444444444444444001
1004444444444444444444444444444444444444444444444444444444001
1004444444444444444444444444444444444444444444444444444444001
1004444444444444444444444444444444444444444444444444444444001
1004444444444444444444444444444444444444444444444444444444001
1004444444444444444444444444444444444444444444444444444444001
1000000000000000000000000000000000000000000000000000000000001
1000000000000000000000000000000000000000000000000000000000001
1111111111111111111111111111111111111111111111111111111111111
