111133333333331111
110032000000030001
166630000020030001
166633330033330001
300000030030000003
300000030030000003
309000040040002203
300000033330000003
300000000000000003
302200000000000001
100000000000200001
110000000000200011
111333333333331111
