111133333333331111
110032000000030001
100040000000440001
100033330033330001
300000030030000003
300000030030000003
30=000040040002203
300000033330000003
300000000000000003
302200000400000003
100000000000200001
140000000000400411
111333333333331111
