33333333333333
30000000000003
30200000000203
30000114110003
30000100010003
30000400040003
30000100010003
30000114110003
30200000000203
30000000000003
33333333333333
